//Convoy Calamity (RUS)

UseTerrain=TRUE
MapCoordinates=800,644

MapNavigationData=campaign/images/maps/norwegian_sea_navmap
MapElevationData=campaign/images/maps/norwegian_sea_bathymetry
WorldObjectsData=campaign/maps/norwegian_sea_world_objects
VesselsAndTraffic=campaign/maps/norwegian_sea_traffic_nato


//Environment
Date=14 NOV 1984
Hemisphere=North
Time=1200
UsePresetEnvironment=FALSE
Weather=Clear
SeaState=LightBreeze
DuctStrength=Moderate
LayerStrength=Moderate

//Enemy Ships
NumberOfEnemyUnits=1-3,1-2,3-5
CombatBehaviour=OFFENSIVE,OFFENSIVE,DEFENSIVE
EnemyUnitMissionCritical=FALSE,FALSE,TRUE
EnemyShipClasses=usn_ff_knox,usn_cg_belknap,civ_ms_encounter|civ_ms_act_1|civ_ms_sl7|civ_ms_freighter_a|civ_ms_freighter_b|civ_ms_super_p|civ_ms_small_freighter
//Ship positions and headings, otherwise build into a formation

//Enemy Aircraft
NumberOfHelicopters=2
HelicopterType=usn_sh-2f
NumberOfAircraft=0
AircraftType=wp_il-38_may

PlayerVessels=wp_ssn_akula1,wp_ssn_akula2,wp_ssn_alfa,wp_ssn_alfa2,wp_ssn_mike,wp_ssn_november,wp_ssn_novemberii,wp_ssn_sierra,wp_ssn_victor1,wp_ssn_victor2,wp_ssn_victor3,wp_ss_foxtrot,wp_ss_kilo,wp_ss_kilo2,wp_ss_lada,wp_ss_romeo,wp_ss_tango,wp_ss_whiskey,wp_ssbn_borei,wp_ssbn_delta4,wp_ssbn_delta3,wp_ssb_golf,wp_ssbn_hotel,wp_ssbn_redoctober,wp_ssbn_redoctober_silent,wp_ssbn_typhoon,wp_ssbn_typhoon_vls,wp_ssbn_yankee,wp_ssgn_charlie1,wp_ssgn_charlie2,wp_ssgn_echo2,wp_ssg_juliet,wp_ssgn_oscar,wp_ssgn_papa,wp_ssgn_yasen,plan_ssn_han,plan_ssn_shang,plan_ssn_sui,plan_ss_kilo,plan_ss_ming,plan_ss_romeo,plan_ssk_song,plan_ssbn_xia,dprk_ss_romeo,vnm_ss_kilo
CommanderName=GLAVCOM VMF
CommanderFleetName=COM NORTHERN FLEET